AAAAAAAAAAAAAAAAAAAAAAAAAAAAAAAAAAAAAAAAAAAAAAAAAA
AAAAAAAAAAAAAAAAAAAAAAAAAAAAAAAAAAAAAAAAAAAAAAAAAA
AABBBBBBBBBBBBBBAABBBBBBBBBBBBBBAABBBBBBBBBBBBBBAA
AABAAAAAAAAAAAABAABAAAAAAAAAAAABAABAAAAAAAAAAAABAA
AABAAAAAAAAAAAABAABAAAAAAAAAAAABAABAAAAAAAAAAAABAA
AABAAAAAAAAAAAABAABAAAAAAAAAAAABAABAAAAAAAAAAAABAA
AABAAAAAAAAAAAABAABAAAAAAAAAAAABAABAAAAAAAAAAAABAA
AABBBBBAAAABBBBBAABBBBBAAAABBBBBAABBBBBAAAABBBBBAA
AAAAAAAAAAAAAAAAAAAAAAAAAAAAAAAAAAAAAAAAAAAAAAAAAA
AAAAAAAAAAAAAAAAAAAAAAAAAAAAAAAAAAAAAAAAAAAAAAAAAA
AAAAAAAAAAAAAAAAAAAAAAAAAAAAAAAAAAAAAAAAAAAAAAAAAA
AAAAAAAAAAAAAAAAAAAAAAAAAAAAAAAAAAAAAAAAAAAAAAAAAA
AABBBBBAAAABBBBBAABBBBBAAAABBBBBAABBBBBAAAABBBBBAA
AABAAAAAAAAAAAABAABAAAAAAAAAAAABAABAAAAAAAAAAAABAA
AABAAAAAAAAAAAABAABAAAAAAAAAAAABAABAAAAAAAAAAAABAA
AABAAAAAAAAAAAABAABAAAAAAAAAAAABAABAAAAAAAAAAAABAA
AABAAAAAAAAAAAABAABAAAAAAAAAAAABAABAAAAAAAAAAAABAA
AABBBBBAAAABBBBBAABBBBBAAAABBBBBAABBBBBAAAABBBBBAA
AAAAAAAAAAAAAAAAAAAAAAAAAAAAAAAAAAAAAAAAAAAAAAAAAA
AAAAAAAAAAAAAAAAAAAAAAAAAAAAAAAAAAAAAAAAAAAAAAAAAA
AAAAAAAAAAAAAAAAAAAAAAAAAAAAAAAAAAAAAAAAAAAAAAAAAA
AAAAAAAAAAAAAAAAAAAAAAAAAAAAAAAAAAAAAAAAAAAAAAAAAA
AABBBBBAAAABBBBBAABBBBBAAAABBBBBAABBBBBAAAABBBBBAA
AABAAAAAAAAAAAABAABAAAAAAAAAAAABAABAAAAAAAAAAAABAA
AABAAAAAAAAAAAABAABAAAAAAAAAAAABAABAAAAAAAAAAAABAA
AABAAAAAAAAAAAABAABAAAAAAAAAAAABAABAAAAAAAAAAAABAA
AABAAAAAAAAAAAABAABAAAAAAAAAAAABAABAAAAAAAAAAAABAA
AABBBBBBBBBBBBBBAABBBBBBBBBBBBBBAABBBBBBBBBBBBBBAA
AAAAAAAAAAAAAAAAAAAAAAAAAAAAAAAAAAAAAAAAAAAAAAAAAA
AAAAAAAAAAAAAAAAAAAAAAAAAAAAAAAAAAAAAAAAAAAAAAAAAA
